

SO     ./sprites/crate1.xpm

NO ./sprites/crate2.xpm
EA ./sprites/vent1.xpm


WE ./sprites/wall1.xpm

F 20,20,20
C   255,30,0


1111111111111
1  1000000001
1  1000000001
1111100000001
100000000111
1000000001
1110111111
1000000001
1000000001
1111111111
