

SO     ./sprites/crate1.xpm

NO ./sprites/crate2.xpm
EA ./sprites/vent1.xpm


WE ./sprites/wall1.xpm

F 2,2,0
C   255,30,0


1111111111111
1  1000000001
1  1000000001
1111000000001
1000N0000111
1000000001
1000000001
1000000001
1000000001
1111111111
